########################################
#                #                     #
#                #                     #
# ######### ############## #############
#         # #            # #       #   #
#  ######## #   ########## #  ###### ###
# ##        ##  #        # #  ###### ###
# ## ########## ########## ##          #
#               #        # ########## ##
############### ########## ########## ##
                                        
#                                      #
########################################
